###################
#A@   $           #
#     o @         #
#         #### @ o#
#  o@             #
#             #   #
#             #   #
#       #######   #
#                 #
#                 #
###################