##############
#   ######
##  ###  #
## @     #
#   A@ # #
### @### #
#  # o  #
## ##o  ##
#      ##
# o   ##
#######
#
#