   ###
  ## # ####
 ##  ###  #
## @      #
#   A@ #  #
### @###  #
  #  # o  #
 ## ##o  ##
 #      ##
 # o   ##
 #######
